www.msn.com/en-in/news/	news
www.msn.com/en-in/entertainment/	showbiz
www.msn.com/en-in/sports/	sports
www.msn.com/en-in/moneuy/	finance
www.msn.com/en-in/lifestyle/	lifestyle
www.msn.com/en-in/health/	health
www.msn.com/en-in/foodanddrink/	food
www.msn.com/en-in/travel/	travel
www.msn.com/en-in/autos/	auto	
in.news.yahoo.com/	news
in.finance.yahoo.com/news/	finance	
cricket.yahoo.com/news/	cricket
in.style.yahoo.com/	lifestyle
allaboutcars.yahoo.com/post/	auto
www.india.com/news/world/	word
www.india.com/news/india/	india
www.india.com/news/cities/	society
www.india.com/sports/	sports
www.india.com/cricket-2/	cricket
www.india.com/showbiz/	showbiz
www.india.com/stream/	Miscallaneous
www.dailypioneer.com/nation/	india
www.dailypioneer.com/business	business
www.dailypioneer.com/world/	word
www.dailypioneer.com/city/	society
www.dailypioneer.com/sports/	sports
indianexpress.com/india/	india
indianexpress.com/article/world/world-news/	world
indianexpress.com/article/opinion/columns/	politics
indianexpress.com/article/lifestyle/	lifestyle
indianexpress.com/article/technology/	technology
indianexpress.com/article/entertainment/	showbiz
www.thestatesman.com/news/india/	india
www.thestatesman.com/news/world/	world
www.thestatesman.com/news/sports/	sports
www.thestatesman.com/news/business/	business
www.thestatesman.com/news/opinion/	politics
www.thestatesman.com/news/life-style/	lifestyle
www.thestatesman.com/news/delhi/	society
www.thestatesman.com/news/bengal/	society
www.thestatesman.com/news/odisha/	society
www.thestatesman.com/news/features/	culture
www.thestatesman.com/news/supplements/	miscallaneous
timesofindia.indiatimes.com/india/	india
timesofindia.indiatimes.com/world/	world
timesofindia.indiatimes.com/business/	business
timesofindia.indiatimes.com/tech/	technology
timesofindia.indiatimes.com/sports/	sports
timesofindia.indiatimes.com/entertainment/	showbiz
timesofindia.indiatimes.com/life-style/	lifestyle
www.deccanchronicle.com/nation/	india
www.deccanchronicle.com/south	india
www.deccanchronicle.com/world	world
www.deccanchronicle.com/entertainment	showbiz
www.deccanchronicle.com/sports	sports
www.deccanchronicle.com/business	business
www.deccanchronicle.com/technology	technology
www.deccanchronicle.com/lifestyle	lifestyle
www.hindustantimes.com/india-news/	india
www.hindustantimes.com/world-news/	world
www.hindustantimes.com/us-presidential-election/	politics
www.hindustantimes.com/editorials/	society
www.hindustantimes.com/analysis/	society
www.hindustantimes.com/cricket/	cricket
www.hindustantimes.com/football/	sports
www.hindustantimes.com/olympics/	sports
www.hindustantimes.com/tennis/	sports
www.hindustantimes.com/other-sports/	sports
www.hindustantimes.com/hollywood/	showbiz
www.hindustantimes.com/bollywood/	showbiz
www.hindustantimes.com/movie-reviews/	miscallaneous
www.hindustantimes.com/tv/	miscallaneous
www.hindustantimes.com/music/	miscallaneous	
www.hindustantimes.com/health-and-fitness/	health
www.hindustantimes.com/art-and-culture/	culture
www.hindustantimes.com/sex-and-relationships/	health
www.hindustantimes.com/fashion-and-trends/	fashion
www.hindustantimes.com/travel/	travel
www.hindustantimes.com/books/	culture
www.hindustantimes.com/tech/	techonlogy
www.hindustantimes.com/business-news/	business
www.hindustantimes.com/autos/	auto
indianexpress.com/article/india/india-news-india/	india
indianexpress.com/article/world/world-news/	world
indianexpress.com/article/opinion/	election
indianexpress.com/article/sports/	sports
indianexpress.com/sports/	sports
indianexpress.com/article/entertainment/	showbiz
indianexpress.com/article/lifestyle/	lifestyle
indianexpress.com/article/technology/	technology
indianexpress.com/article/trending/	trending
www.rediff.com/news/	news
www.rediff.com/business/	business
www.rediff.com/movies/report/	miscallaneous
www.rediff.com/sports/report/	sports
www.rediff.com/cricket/report/	cricket
zeenews.india.com/news/net-news/	news
zeenews.india.com/news/india/	india
zeenews.india.com/news/world/	world
zeenews.india.com/news/americas/	U.S
zeenews.india.com/news/africa/	world
zeenews.india.com/news/australia-oceania/	world
zeenews.india.com/news/europe/	world
zeenews.india.com/news/asia/	world
zeenews.india.com/business/news/finance/	finance
zeenews.india.com/business/news/economy/	economy
zeenews.india.com/business/news/companies/	businuss
zeenews.india.com/business/news/international/	business
zeenews.india.com/business/realestate/	business
zeenews.india.com/business/automobiles/	auto
zeenews.india.com/business/gadgets/gadgets-news/	technoloty	
zeenews.india.com/news/internet-social-media/	society
zeenews.india.com/news/environment/	spirituality
zeenews.india.com/news/space/	technology
zeenews.india.com/news/internet-social-media/	society
zeenews.india.com/news/science/	science
zeenews.india.com/sports/	sports
zeenews.india.com/entertainment/	showbiz	
zeenews.india.com/health/	health